XXXXXXXXXXXXXXXXXXXXXXXXXXXXXXXXXXXXXXXXXXXXXXXXXXXXXXXXXXXXXXXXXXXXXXXXXXXXXXXXXXXXXXXXXXXXXXXXXXXXXXXXXXXXXXXXXXXXXXXX
X              X            X                             X                                          X                 X
X              X            X                             X                                          X                 X
X              X            X                             X                                          X                 X
X                                                                                                    X                 X
X                                                                                                    X                 X
X              X            X                                                                        X                 X
X              X            X                             X                                          X                 X
X              X            X                             X                                          XXXXXX       XXXXXX
X              XXXXX    XXXXX                             X                                                            X
X              X                         XXXX             XXXXXXXXX    XXXXXXXXX                                       X
X              X                            X                                  X                                       X
X                                           X                                  X                                       X
X                                                                              X                                      
X                                                                              X                          
X              X                                                                                                        
X              X                                                                                                      
X              X                                     XX        XX                                                      X
X              X            X                         XX      XX                       X                       XXXXXXXXX
X              X            X                          XX    XX                        X                     XXX       X
X              X            X                           XXXXXX                         X                   XXX         X
X                           X                             XX                           X                 XXX           X
X                           X                                                                                          X
X                           X                                                                                          X
X                           X                                                                                          X
X              X            X          X                                      X                 XXX                    X
X              X            X          X                                      X               XXX                      X
X              X            X          X        X                    X        X             XXX                        X
X              X            X          X        X                    X        X           XXX                          X
XXXXXXXXXXXXXXXXXXXXXXXXXXXXXXXXXXXXXXXXXXXXXXXXXXXXXXXX      XXXXXXXXXXXXXXXXXXXXXXXXXXXXXXXXXXXXXXXXXXXXXXXXXXXXXXXXXX
XXXXXXXXXXXXXXXXXXXXXXXXXXXXXXXXXXXXXXXXXXXXXXXXXXXXXXXX      XXXXXXXXXXXXXXXXXXXXXXXXXXXXXXXXXXXXXXXXXXXXXXXXXXXXXXXXXX
X                                                                                                                      X
X                                                                                                                      X
X                                                                                                                      X
X                                                                                                                      X
X                                                                                                                      X
X                                                                                                                      X
X                                                                                                                      X
X                                                                                                                      X
X                                                                                                                      X
X                                                                                                                      X
X                                                                                                                      X
X                                                                                                                      X
X                                                                                                                      
X                                                                                                                      
X                                                                                                                      
X                                                                                                                      
X                                                                                                                      X
X                                                                                                                      X
X                                                                                                                      X
X                                                                                                                      X
X                                                                                                                      X
X                                                                                                                      X
X                                                                                                                      X
X                                                                                                                      X
X                                                                                                                      X
X                                                                                                                      X
X                                                                                                                      X
X                                                                                                                      X
XXXXXXXXXXXXXXXXXXXXXXXXXXXXXXXXXXXXXXXXXXXXXXXXXXXXXXXXXXXXXXXXXXXXXXXXXXXXXXXXXXXXXXXXXXXXXXXXXXXXXXXXXXXXXXXXXXXXXXXX
XXXXXXXXXXXXXXXXXXXXXXXXXXXXXXXXXXXXXXXXXXXXXXXXXXXXXXXXXXXXXXXXXXXXXXXXXXXXXXXXXXXXXXXXXXXXXXXXXXXXXXXXXXXXXXXXXXXXXXXX
X                                                                                                                      X
X                                                                                                                      X
X                                                                                                                      X
X                                                                                                                      X
X                                                                                                                      X
X                                                                                                                      X
X                                                                                                                      X
X                                                                                                                      X
X                                                                                                                      X
X                                                                                                                      X
X                                                                                                                      X  
X                                                                                                                      X
                                                                                                                       X
                                                                                                                       X
                                                                                                                       X
                                                                                                                       X
X                                                                                                                      X
X                                                                                                                      X
X                                                                                                                      X
X                                                                                                                      X
X                                                                                                                      X
X                                                                                                                      X
X                                                                                                                      X
X                                                                                                                      X
X                                                                                                                      X
X                                                                                                                      X
X                                                                                                                      X
X                                                                                                                      X
XXXXXXXXXXXXXXXXXXXXXXXXXXXXXXXXXXXXXXXXXXXXXXXXXXXXXXXX      XXXXXXXXXXXXXXXXXXXXXXXXXXXXXXXXXXXXXXXXXXXXXXXXXXXXXXXXXX
XXXXXXXXXXXXXXXXXXXXXXXXXXXXXXXXXXXXXXXXXXXXXXXXXXXXXXXX      XXXXXXXXXXXXXXXXXXXXXXXXXXXXXXXXXXXXXXXXXXXXXXXXXXXXXXXXXX
X                                                                                                                      X
X                                                                                                                      X
X                                                                                                                      X
X                                                                                                                      X
X                                                                                                                      X
X                                                                                                                      X
X                                                                                                                      X
X                                                                                                                      X
X                                                                                                                      X
X                                                                                                                      X
X                                                                                                                      X
X                                                                                                                      X
                                                                                                                       X
                                                                                                                       X
                                                                                                                       X
                                                                                                                       X
X                                                                                                                      X
X                                                                                                                      X
X                                                                                                                      X
X                                                                                                                      X
X                                                                                                                      X
X                                                                                                                      X
X                                                                                                                      X
X                                                                                                                      X
X                                                                                                                      X
X                                                                                                                      X
X                                                                                                                      X
X                                                                                                                      X
XXXXXXXXXXXXXXXXXXXXXXXXXXXXXXXXXXXXXXXXXXXXXXXXXXXXXXXXXXXXXXXXXXXXXXXXXXXXXXXXXXXXXXXXXXXXXXXXXXXXXXXXXXXXXXXXXXXXXXXX